19
30
RRRRRRRRRRRRRRRRRRR
RRRRRRRRXXXRRRRRRRR
RRRRRRRRXWXRRRRRRRR
RRRRRRRRXXXRRRRRRRR
RRRRRRRRFFFRRRRRRRR
RRRRRFFFFFFFFFRRRRR
FFFFFFFFFFFFFFFFFFF
FFFFFFFFFFFFFFFFFFF
FFFFFFFFFFFFFFFFFFF
FFFFFFFFFFFFFFFFFFF
FFFFFFFFFFFFFFFFFFF
FFFFFFFFFFFFFFFFFFF
FFFFFFFFFFFFFFFFFFF
FFFFFFFFFFFFFFFFFFF
FFFFFFFFFFFFFFFFFFF
FFFFFFFFFFFFFFFFFFF
FFFFFFFFFFFFFFFFFFF
FFFFFFFFFFFFFFFFFFF
FFFFFFFFFFFFFFFFFFF
FFFFFFFFFFFFFFFFFFF
FFFFFFFFFFFFFFFFFFF
FFFFFFFFFFFFFFFFFFF
FFFFFFFFFFFFFFFFFFF
FFFFFFFFFFFFFFFFFFF
FFFFFFFFFFFFFFFFFFF
RRRRRRRFFFFFRRRRRRR
RRRRRRRFFFFFRRRRRRR
RRRRRRRFFFFFRRRRRRR
RRRRRRRFFFFFRRRRRRR
RRRRRRRRRRRRRRRRRRR