17
19
RRRRRRRRRRRRRRRRR
RRRRRRRXXXRRRRRRR
RRRRRRRXWXRRRRRRR
RRRRRRRXXXRRRRRRR
RRRRRRRRFRRRRRRRR
RRRRRRFFFFFRRRRRR
RRRRFFFFFFFFFRRRR
RRRRFFFFFFFFFRRRR
RRRFFCFFFFFFFFRRR
RRRFFFFFFFCFFFRRR
RRRFFFCFFFFFFFRRR
RRRRFFFFFFFFFRRRR
RRRRRRRRFRRRRRRRR
RRRRRRRRFRRRRRRRR
RRRRRRRFFFRRRRRRR
RRRRRRRFFFRRRRRRR
RRRRRRRFFFRRRRRRR
RRRRRRRRRRRRRRRRR
RRRRRRRRRRRRRRRRR