27
26
RRRRRRRRRRRRRRRRRRRRRRRRRRR
RRRRRRRRRRRRXXXRRRRRRRRRRRR
RRRRRRRRRRRRXEXRRRRRRRRRRRR
RRRRRRRRRRRRXXXRRRRRRRRRRRR
RRRRRRRRRRRRFFFRRRRRRRRRRRR
RRRRRRRRRFFFFFFFFFRRRRRRRRR
RRFFFFFFFFFFFCFFFFFFFFFFFRR
RRFFFFFFFFFFFCFFFFFFFFFFFRR
RRFFFFCCFFFFFFFFFFFCCFFFFRR
RRFFFFFCCFFFFFFFFFCCFFFFFRR
RRFFFFFFFFFFFFFFFFFFFFFFFRR
RRFFFFFFFFFFFFFFFFFFFFFFFRR
RRFFFFFCCFFFFFFFFFCCFFFFFRR
RRFFFFCCFFFFFFFFFFFCCFFFFRR
RRFFFFFFFFFFCCCFFFFFFFFFFRR
RRFFFFFFFFFFFFFFFFFFFFFFFRR
RRFFRRRRRRRRRRRRRRRRRRRRRRR
RRFFRRRRRRRRRRRRRRRRRRRRRRR
RRFFRRRRRRRRRRRRRRFFRRRRRRR
RRFFRRRRRRRRRRRRRRFFRRRRRRR
RRFFRRRRRRRRRRRRRRFFRRRRRRR
RRFFFFFFFFFFFFFFFFFFRRRRRRR
RRFFFFFFFFFFFFFFFFFFRRRRRRR
RRRRRRRRRRRRRRRRRRRRRRRRRRR
RRRRRRRRRRRRRRRRRRRRRRRRRRR
RRRRRRRRRRRRRRRRRRRRRRRRRRR